
		F 87,143,74		

NO 		 ./textures/north.png
			SO ./textures/south.png
  	WE ./textures/west.png

EA ./textures/east.png

C 238,226,189 

1111111111111111111111111111
1000000000000000000000000001
1001111111111111111111111101
1001                     101
1001      1111111111111  101
1001      1000000000001  101
1001      1011111111101  101
1001      101       101  101
1001      101    111101  101
1001      101   1W00101  101
1001      101    110101  101
1001      101     10001  101
1001      101     11111  101
1001      101111111111111101
1001      100000000000000001
1001     1011111111111111111
1111      1 
1111
1111
1111
1111